NO ./texture/NO.xpm
SO ./texture/SO.xpm
EA ./texture/EA.xpm
WE ./texture/WE.xpm
F 12,10,50
C 25,150,10

11111   11111
10011   11001
1000111110001
1100000000001
1110000000111
  110000001
  11100001
  1100S011
11100001001111
1000000000001
1000111110001
10001   10001
11111   11111