111111
100101
101001
11N101
111111
